15 10
###############
#H     TT    M#
#             #
#             #
#      ##     #
#      ##     #
#      G      #
#             #
#M     TT    E#
###############
4
6 1 9 1
9 1 6 1
6 8 9 8
9 8 6 8
