11 9
    ######
    #   M#
##### #####
#H       T#
#         #
#         #
#T       E#
###########
