15 10
###############
#O    TT     M#
#             #
#             #
#             #
#             #
#             #
#             #
#M    TT      #
###############
