16 14
################
#T            T#
#  ##########  #
#  #        #  #
#  #        #  #
#  # #####  #  #
#  ###   ####  #
#H    EM       #
#  ###   ####  #
#  # #####  #  #
#  #        #  #
#  ##########  #
#T            T#
################
