16 10
################
#H    T  T    M#
#              #
#              #
#      ##      #
#      ##      #
#              #
#              #
#M    T  T    E#
################
4
7 1 7 8
7 8 7 1
8 1 8 8
8 8 8 1
