16 10
#########
#H      #
# ## ## #
# ## ## #
#   G   #
# ## ## #
# ## ## #
#      E#
#########
