17 11
        #
 #######T#######
 #H           G#
 # ## ## ## ## #
 # ## ## ## ## #
#T             T#
 # ## ## ## ## #
 # ## ## ## ## #
 #G           E#
 #######T#######
        #
4
5 1 11 1
11 1 11 9
11 9 5 9
5 9 5 1
